1111111111
1000100001
1000100001
1000111101
1000000001
1111000001
1010000001
1010111111
1010000001
1000011111
1010000001
1010110001
1010010001
1010010401
1111111111